11111111111
10000C00001
10010011C01
11110110101
10011100101
100000P1101
10100001101
11001000E01
1C000000001
11111111111