1111111111
10000C0001
10010011C1
1111011011
1001110011
10000P1111
1010000111
1100100001
1C000000E1
1111111111